15	14	0	0	0	0	0	12	12	11	11
14	14	14	0	0	8	8	8	8	8	11
14	14	14	0	0	8	6	6	6	6	6
0	14	14	14	0	8	6	7	7	7	7
0	0	14	14	0	8	6	7	7	7	5
0	0	0	8	8	1	2	2	2	3	4
0	0	8	8	0	8	6	7	7	7	5
8	8	8	0	0	8	6	7	7	7	7
8	0	0	0	0	8	6	6	6	6	6
8	0	0	0	0	8	8	8	8	9	10
13	0	0	0	0	12	12	12	12	10	10
